F 164,169,20
C 153,204,255

NO /home/abjellal/Videos/cub3d/xpm_files/wall.xpm
SO /home/abjellal/Videos/cub3d/xpm_files/wall.xpm
WE /home/abjellal/Videos/cub3d/xpm_files/wall.xpm
EA /home/abjellal/Videos/cub3d/xpm_files/wall.xpm

11111111111111111111111111111111111111111111111111111
1E000000000000100000000000000000000000000000000000001
10111111111010101111111111101111111111111111111111001
10100000001010100000000000100000000000000000000001001
10101111101010101111111110101111111111111111111001001
10101000101000101000000100100000000001000000001001001
10101010101111101011110111101111111011101111101001001
10101010100000101010000100001000001000101000001001001
10101010111110101110111101111011101011101110101001001
10100010000010100010000100000000101000001000101001001
10111110111010101111110111111110101111111011101001001
10000000101000100000010000000000100000000000101000001
11101111101111101111011111101111101111111110101111111
10001000001000001000001000001000001000000000100000001
10111011111011111011101011111011111011101111111111001
10100010000010000010101010000010000010100000000001001
10101110111110111110111010111110111110111111111001001
10101000100000100010001010000100000100000000001001001
10101011101111101110101011110111110111111110101001001
10100000101000001000101000000100010000000100101001001
10111110101110111011101111110101011111011110101001001
10000010100010000010000000000101000001000000101000001
11111010111011111011111111110101111101111111101111111
10000010001000001000000000000100000100000000000000001
10111111101111101111111111111111110111111111111111001
10000000001000001000000000000000000100000000000001001
11111111111111000000000000000000000011111111111111111
11111111111111000000000000000000000011111111111111111
11111111111111000000000000000000000011111111111111111
11111111111111000000000000000000000011111111111111111
11111111111111000000000000000000000011111111111111111
11111111111111000000000000000000000011111111111111111
11111111111111111111111111111111111111111111111111111
