F 164,169,20
C 153,204,255

NO /home/yael-bar/Desktop/aaaa/xpm_files/north.xpm
SO /home/yael-bar/Desktop/aaaa/xpm_files/south.xpm
WE /home/yael-bar/Desktop/aaaa/xpm_files/west.xpm
EA /home/yael-bar/Desktop/aaaa/xpm_files/east.xpm


    111111111
    100000111
1111100001
1000000E01
111111111