	F     164,169,20
C 153,204,255

NO ./xpm_files/wall.xpm
SO ./xpm_files/wall.xpm
WE ./xpm_files/wall.xpm
EA ./xpm_files/wall.xpm


    111111111
    100000111
1111100001
1000000E01
111111111
