F 164,169,20
C 153,204,255

NO textures/simonkraft/wet_sponge.xpm
SO textures/simonkraft/wet_sponge.xpm
WE textures/simonkraft/wet_sponge.xpm
EA textures/simonkraft/wet_sponge.xpm


    111111111
    100000111
1111100001
1000E00001
111111111