F 148,0,211
C 0,191,255

NO /home/abjellal/Videos/cub3d/xpm_files/wall.xpm
SO /home/abjellal/Videos/cub3d/xpm_files/wall.xpm
WE /home/abjellal/Videos/cub3d/xpm_files/wall.xpm
EA /home/abjellal/Videos/cub3d/xpm_files/wall.xpm

1111111111111111111111111111111111
1010000000000010000000000000000001
10000100000001010111111111111100001
101010100000010011          1000011
1000110000010000011         100001
1000110000000000011         1000011
1000110000W000000001         1000001
10001100000000000001       11000011
10001111111111111101     11000011
10001            101111 1000011
1001          111000000100011
101         110000000000001
101        10000000000000001
101       1000000000000000001
101111111100000000001000000001
100000000000000000010000000001
111111111100000000000000000001
          1000000000000000001
           10000000000000001
            110000000000011
              111000001111
               1111111