F 220,20,60
C 220,191,255

NO /home/abjellal/Videos/cub3d/xpm_files/wall.xpm
SO /home/abjellal/Videos/cub3d/xpm_files/wall.xpm
WE /home/abjellal/Videos/cub3d/xpm_files/wall.xpm
EA /home/abjellal/Videos/cub3d/xpm_files/wall.xpm


1111111111111111111111111111111111111111111111111111111111
1000000000000000000000000000110000000000000000000000000001
1111011111111101110000001000111110111111111011100000010001
1111011111111101110101001000111110111111111011101010010001
1100000011010101110000001000111000000110101011100000010001
1000000E00000000110000001000110000000000000001100000010001
1000000000000000101010010001000000000000000001010100100011
1100000111110111111111000111111000001111101111111110001111
1111111111111111111111111111111111111111111111111111111111