111111111111
101000000001
10F000000001
10100EF1F111
100000000001
111111111111