F 34,139,34
C 0,191,255

NO ./xpm_files/wall.xpm
SO ./xpm_files/wall.xpm
WE ./xpm_files/wall.xpm
EA ./xpm_files/wall.xpm

111111111111
101000000001
100000000001
10100E010111
100000000001
111111111111