F 64,64,64
C 0,191,255

NO ./xpm_files/wall.xpm
SO ./xpm_files/wall.xpm
WE ./xpm_files/wall.xpm
EA ./xpm_files/wall.xpm

1111111111111111111111111
1000000000110000000000001
1011000001110000000000001
10010000000000000000000011111111
111111111011000001110000000000001
100000000011000001110111111111111
11110111111111011100000010001
11110111111111011101010010001
11000000110101011100000010001
10000000000000001100000010001
10000000000000001101010000001
11000001110101011111011110N0111
11111111111111111111111111111111