F 220,20,60
C 220,191,255

NO ./xpm_files/wall.xpm
SO ./xpm_files/wall.xpm
WE ./xpm_files/wall.xpm
EA ./xpm_files/wall.xpm

11111111111111111111111111111111111111111111111111111111
10000000000000000000000000000000000000000000000000000001
10000000000000000000000000000000000000000000000000000001
10000000000000000000000000000000000000000000000000000001
10000000000000000000000000000000000000000000000000000001
10000000000000000000000000000000000000000000000000000001
10000000000000000000000000000000000000000000000000000001
10000000000000000000000000000000000000000000000000000001
10000000000000000000000000000000000000000000000111111111
10000000000000000000000000000000000000000000000100000001
10000000000000000000000000000000000000000001111100000001
10000000000000000000000000000000000000001110000000S00001
10000000000000000000000000000000000000000001011100000001
10000000000000000000000000000000000000001100010100000001
10000000000000000000000000000000000000000111110111111111
10000000000000000000000000000000000000000000000000000001
10000000000000000000010000000000000000000000000000000001
10000000000000000000101000000000000000000000000000000001
10000000000000000001000100000000000000000000000000000001
10000000000000000001000100000000000000000000000000000001
10000000000000000001000100000000000000000000000000000001
10000000000000000001000100000000000000000000000000000001
10000000000000000001000100000000000000000000000000000001
10000000000000000110100011000000000000000000000000000001
10000000000000000100011000100000000000000000000000000001
10000000000000000011100111000000000000000000000000000001
10000000000000000000000000000000000000000000000000000001
11111111111111111111111111111111111111111111111111111111
